Keep your eye on the ball — Сосредоточьтесь на главном

Confidence under pressure — Уверенность под давлением

Re-frame the conversation — Переосмыслите разговор

Focus on the problem at hand — Сфокусируйтесь на текущей задаче

Service mindset — Ориентация на помощь

Provide solutions — Предлагайте решения

Speak in outcomes — Говорите о результатах

Connect past experience to present needs — Связывайте прошлый опыт с текущими задачами

Use the language of numbers — Используйте язык цифр

Facts and statistics — Факты и статистика

Clarification questions — Уточняющие вопросы

Selfless service — Бескорыстное служение

Confidence is a matter of focus — Уверенность — это вопрос фокуса

Practice deep breathing — Практикуйте глубокое дыхание

Positive visualization — Позитивная визуализация

Natural eye contact — Естественный зрительный контакт

Relaxed body posture — Расслабленная осанка

Sit upright — Сидите прямо

Open and friendly attitude — Открытое и дружелюбное поведение

Avoid fidgeting — Избегайте суетливости

Slow, thoughtful answers — Медленные и обдуманные ответы

Take your time when responding — Не спешите с ответами

Prepare and rehearse — Готовьтесь и тренируйтесь

Ask for clarification — Попросите разъяснение

Show interest in the role — Проявите интерес к роли

Enthusiastic final words — Энтузиазм в финальных словах

Project confidence — Проявляйте уверенность

Think positively — Думайте позитивно

Speak clearly and slowly — Говорите ясно и медленно

Focus on what you can offer — Сфокусируйтесь на том, что вы можете предложить